#####
#                                        #
#                002                     #
#                 |                      #
#                 |                      #
#                001                     #
#                 |                      #
#                 |                      #
#      008--007--000--003--004           #
#                 |                      #
#                 |                      #
#                005                     #
#                 |                      #
#                 |                      #
#                006                     #
#                                        #

#####

{
  0: [(3, 5), {'n': 1, 's': 5, 'e': 3, 'w': 7}],
  1: [(3, 6), {'s': 0, 'n': 2}],
  2: [(3, 7), {'s': 1}],
  3: [(4, 5), {'w': 0, 'e': 4}],
  4: [(5, 5), {'w': 3}],
  5: [(3, 4), {'n': 0, 's': 6}],
  6: [(3, 3), {'n': 5}],
  7: [(2, 5), {'w': 8, 'e': 0}],
  8: [(1, 5), {'e': 7}]
}